//MAP CONVERTED BY dmm2tgm.py THIS HEADER COMMENT PREVENTS RECONVERSION, DO NOT REMOVE
"b" = (
/obj/effect/turf_decal/caution{
	dir = 8
	},
/obj/effect/turf_decal/stripes/line{
	dir = 8
	},
/obj/structure/fluff/railing{
	density = 0;
	dir = 8
	},
/turf/open/floor/plasteel/f13/vault_floor/misc/vaultrust{
	name = "metal plating"
	},
/area/shuttle/entrance_elevator)
"f" = (
/obj/effect/turf_decal/stripes/line{
	dir = 9
	},
/obj/machinery/light/floor,
/obj/structure/railing{
	dir = 9;
	layer = 4.1
	},
/turf/open/floor/plasteel/f13/vault_floor/misc/vaultrust{
	name = "metal plating"
	},
/area/shuttle/entrance_elevator)
"h" = (
/obj/effect/turf_decal/stripes/line{
	dir = 1
	},
/obj/structure/railing/corner{
	dir = 1
	},
/turf/open/floor/plasteel/f13/vault_floor/misc/vaultrust{
	name = "metal plating"
	},
/area/shuttle/entrance_elevator)
"l" = (
/obj/effect/turf_decal/stripes/line{
	dir = 8
	},
/obj/machinery/computer/shuttle/bosentryelevator{
	dir = 4
	},
/obj/structure/fluff/railing{
	density = 0;
	dir = 8
	},
/turf/open/floor/plasteel/f13/vault_floor/misc/vaultrust{
	name = "metal plating"
	},
/area/shuttle/entrance_elevator)
"s" = (
/obj/effect/turf_decal/stripes/line{
	dir = 10
	},
/obj/machinery/light/floor,
/obj/structure/railing{
	dir = 10;
	layer = 4.1
	},
/turf/open/floor/plasteel/f13/vault_floor/misc/vaultrust{
	name = "metal plating"
	},
/area/shuttle/entrance_elevator)
"t" = (
/obj/effect/turf_decal/stripes/line{
	dir = 8
	},
/obj/effect/turf_decal/caution{
	dir = 8
	},
/obj/structure/fluff/railing{
	density = 0;
	dir = 8
	},
/turf/open/floor/plasteel/f13/vault_floor/misc/vaultrust{
	name = "metal plating"
	},
/area/shuttle/entrance_elevator)
"v" = (
/obj/docking_port/mobile/elevator{
	can_move_docking_ports = 1;
	dir = 8;
	dwidth = 1;
	height = 4;
	id = "entrance_elevator";
	name = "BOS Entrance Elevator";
	width = 5
	},
/obj/effect/turf_decal/caution{
	dir = 4
	},
/obj/effect/turf_decal/stripes/line{
	dir = 4
	},
/obj/structure/railing/corner,
/turf/open/floor/plasteel/f13/vault_floor/misc/vaultrust{
	name = "metal plating"
	},
/area/shuttle/entrance_elevator)
"y" = (
/obj/effect/turf_decal/stripes/line{
	dir = 4
	},
/turf/open/floor/plasteel/f13/vault_floor/misc/vaultrust{
	name = "metal plating"
	},
/area/shuttle/entrance_elevator)
"A" = (
/turf/open/floor/plasteel/f13/vault_floor/misc/vaultrust{
	name = "metal plating"
	},
/area/shuttle/entrance_elevator)
"B" = (
/obj/effect/turf_decal/stripes/line{
	dir = 6
	},
/obj/machinery/light/floor,
/obj/structure/railing{
	dir = 6;
	layer = 4.1
	},
/turf/open/floor/plasteel/f13/vault_floor/misc/vaultrust{
	name = "metal plating"
	},
/area/shuttle/entrance_elevator)
"D" = (
/obj/effect/turf_decal/stripes/line{
	dir = 1
	},
/obj/structure/railing/corner{
	dir = 4
	},
/turf/open/floor/plasteel/f13/vault_floor/misc/vaultrust{
	name = "metal plating"
	},
/area/shuttle/entrance_elevator)
"J" = (
/obj/effect/turf_decal/stripes/line{
	dir = 4
	},
/obj/effect/turf_decal/caution{
	dir = 4
	},
/obj/structure/railing/corner{
	dir = 4
	},
/turf/open/floor/plasteel/f13/vault_floor/misc/vaultrust{
	name = "metal plating"
	},
/area/shuttle/entrance_elevator)
"T" = (
/obj/effect/turf_decal/stripes/line{
	dir = 5
	},
/obj/machinery/light/floor,
/obj/structure/railing{
	dir = 5
	},
/turf/open/floor/plasteel/f13/vault_floor/misc/vaultrust{
	name = "metal plating"
	},
/area/shuttle/entrance_elevator)
"W" = (
/obj/effect/turf_decal/stripes/line,
/obj/structure/railing/corner,
/turf/open/floor/plasteel/f13/vault_floor/misc/vaultrust{
	name = "metal plating"
	},
/area/shuttle/entrance_elevator)
"Y" = (
/obj/structure/simple_door/metal/vaultreinforced,
/turf/open/space/basic,
/area/space)
"Z" = (
/obj/effect/turf_decal/stripes/line,
/obj/structure/railing/corner{
	dir = 8
	},
/turf/open/floor/plasteel/f13/vault_floor/misc/vaultrust{
	name = "metal plating"
	},
/area/shuttle/entrance_elevator)

(1,1,1) = {"
Y
Y
Y
Y
Y
Y
Y
"}
(2,1,1) = {"
Y
f
t
l
b
s
Y
"}
(3,1,1) = {"
Y
h
A
A
A
Z
Y
"}
(4,1,1) = {"
Y
D
A
A
A
W
Y
"}
(5,1,1) = {"
Y
T
J
y
v
B
Y
"}
(6,1,1) = {"
Y
Y
Y
Y
Y
Y
Y
"}
